          ###################
          #                 #
          #                 #
          #                 #
          #                 #
          #                 #
          #                 #
          #                 #
          #                 #
          #                 #
          #                 #
          #        O        #
          #        o        #
          #        o        #
          #        o        #
          #                 #
          #                 #
          #                 #
          #                 #
          ###################