###################
#                 #
#                 #
#                 #
#                 #
#         O       #
#         o       #
#         o       #
#                 #
###################