@@@@@@@@@@@@@@@@@@@
@.................@
@.................@
@.................@
@.................@
@.................@
@.................@
@.......V.........@
@.................@
@@@@@@@@@@@@@@@@@@@