@@@@@@@@@@@@@@@@@@@
@                 @
@                 @
@                 @
@                 @
@                 @
@                 @
@       V         @
@                 @
@@@@@@@@@@@@@@@@@@@